1111111111111111111111111111111111
1E1000C0001000000000C1000000000001
1010111110100C0011100100000CC10101
10101CCC101011100C1001000111110101
1P00000000000C000000000C00000001C1
1111111111111111111111111111111111
